{
  "description": "Wafer Layout Configuration. 1 = Valid Site, 0 = No Site",
  "start_site_id": 1,
  "layout_grid": [
    [1, 1, 0, 0, 0],
    [1, 1, 1, 0, 0],
    [1, 1, 1, 1, 0],
    [1, 1, 1, 1, 0],
    [1, 1, 1, 1, 1],
    [1, 1, 1, 1, 1],
    [1, 1, 1, 1, 1],
    [1, 1, 1, 1, 1],
    [1, 1, 1, 1, 1],
    [1, 1, 1, 1, 0],
    [1, 1, 1, 1, 0],
    [1, 1, 1, 0, 0],
    [1, 1, 0, 0, 0]
  ]
}
